____#####__________
____#___#__________
____#$__#__________
__###__$##_________
__#__$_$_#_________
###_#_##_#___######
#___#_##_#####__..#
#_$__$__________..#
#####_###_#@##__..#
____#_____#########
____#######________