############__
#..__#_____###
#..__#_$__$__#
#..__#$####__#
#..____@_##__#
#..__#_#__$_##
######_##$_$_#
__#_$__$_$_$_#
__#____#_____#
__############