________########_
________#_____@#_
________#_$#$_##_
________#_$__$#__
________##$_$_#__
#########_$_#_###
#....__##_$__$__#
##...____$__$___#
#....__##########
########