___________########
___________#__....#
############__....#
#____#__$_$___....#
#_$$$#$__$_#__....#
#__$_____$_#__....#
#_$$_#$_$_$########
#__$_#_____#_______
##_#########_______
#____#____##_______
#_____$___##_______
#__$$#$$__@#_______
#____#____##_______
###########________