________#####____
________#___#####
________#_#$##__#
________#_____$_#
#########_###___#
#....__##_$__$###
#....____$_$$_##_
#....__##$__$_@#_
#########__$__##_
________#_$_$__#_
________###_##_#_
__________#____#_
__________######_